//MAP CONVERTED BY dmm2tgm.py THIS HEADER COMMENT PREVENTS RECONVERSION, DO NOT REMOVE
"a" = (
/turf/simulated/floor/marble,
/area/space)
"k" = (
/obj/random/action_figure,
/obj/random/action_figure,
/turf/simulated/floor/lino/diamond,
/area/space)
"q" = (
/obj/random/action_figure,
/turf/simulated/floor/shuttle,
/area/space)
"s" = (
/obj/random/action_figure,
/turf/simulated/floor/lino/diamond,
/area/space)
"B" = (
/turf/simulated/floor/lino/diamond,
/area/space)
"E" = (
/turf/simulated/wall,
/area/space)
"F" = (
/turf/simulated/floor/shuttle,
/area/space)
"J" = (
/obj/random/chameleon,
/turf/simulated/floor/shuttle,
/area/space)
"W" = (
/obj/random/chameleon,
/turf/simulated/floor/lino/diamond,
/area/space)
"Y" = (
/obj/random/action_figure,
/turf/simulated/floor/marble,
/area/space)
"Z" = (
/obj/random/chameleon,
/turf/simulated/floor/marble,
/area/space)

(1,1,1) = {"
E
E
E
E
E
E
E
E
E
E
E
E
E
E
E
"}
(2,1,1) = {"
E
B
B
B
B
B
B
B
B
B
B
B
B
B
E
"}
(3,1,1) = {"
E
B
a
a
a
a
a
a
a
a
B
B
B
B
E
"}
(4,1,1) = {"
E
B
B
B
B
B
B
B
B
a
a
a
B
B
E
"}
(5,1,1) = {"
E
F
B
s
B
B
B
B
B
B
B
Y
s
B
E
"}
(6,1,1) = {"
E
F
B
s
B
B
B
B
s
B
s
Y
s
s
E
"}
(7,1,1) = {"
E
F
B
s
B
B
k
k
s
s
B
a
B
B
E
"}
(8,1,1) = {"
E
F
F
s
B
k
k
B
B
B
B
a
a
W
E
"}
(9,1,1) = {"
E
B
F
B
k
s
B
B
B
B
B
B
a
W
E
"}
(10,1,1) = {"
E
B
F
B
k
B
B
B
B
B
B
B
Z
W
E
"}
(11,1,1) = {"
E
B
F
F
q
B
B
B
B
B
B
W
Z
B
E
"}
(12,1,1) = {"
E
B
B
s
F
F
F
F
B
B
W
W
B
B
E
"}
(13,1,1) = {"
E
B
B
s
B
B
B
J
J
J
B
B
B
B
E
"}
(14,1,1) = {"
E
B
s
B
B
B
W
W
B
F
F
B
B
B
E
"}
(15,1,1) = {"
E
E
E
E
E
E
E
E
E
E
E
E
E
E
E
"}
